17000000000000000000000000000016
17000000000000000000000000000016
17170000000000000000000000001616
17171700000000000000000000161616
17171717000000000000000016161616
17171717170000000000001616161616
17171717171700000000161616161616
17171717171717000016161616161616
17171717171717000016161616161616
17171717171717000016161616161616
17171717171717000016161616161616
17171717171717000016161616161616