1111111111111111
0000000000000000
0000000000000000
0000000000000000
0000000000000000
0000000000000000
0000000000000000
0000000000000000
6666666666666666
0000000000000000
0000000000000000
1111111111111111