01010101010101010101210101010101
00000000000000000000200000000000
00000000000000000000220000000000
01080000000000000000000000000000
00020000000000000000000000000000
00020000000000000000010000010000
00020000000000000000000000000000
00020000000000000000000000000000
00020000000000000000000000000000
00020000000000000000000000000002
00020000000000000000000000000002
19191919191919191919191919191911