09010101010101010101010101010101
03000000000000000000000000000000
03000000000000000000000000000000
03000000000000000000000000000000
03000000000000000000000000000000
03000000000000000000000000000000
03000000000000000000000000000000
03000000000000000000000000000000
03060506060606060606060606060606
03000700000000000000000000000000
03000700000000000000000000000000
10191919191919191919191919191919