1111111111111111
0000000000000000
0000000000000000
0000010000000000
0000000000000000
0000000000000000
0000000000200000
0000000000000000
0006656666666666
0000070000000000
0000070000000000
1100070000000011