01010101010101010101010121010101
00000000000000000000000020000000
00000000000000000000000020000000
00000000000000000000000022000001
00000000000000000000000000000000
00000000000000000000000000000000
00000000000000000000000000000000
00000000000000002000000223030000
00000000000000002000000223030000
00000000000000002000002601250000
00000000000000002000000000000000
19191919191919192419191919191919