01010101010101010101010101010101
00000000000000000000000000000000
00000000000000000000000000000000
00000100000000000000000000000000
00000000000000000000000000000000
00000000000000000000000000000000
00000000000000000000000000000000
00000000000000000000000000000000
00060606060606060606060606060606
00000700000000000000000000000000
00000700000000000000000000000000
01010701010101010101010101010101