01010101010101210101010101010108
00000000000000200000000000000002
00000000000000200000000000000002
00000000000000200000000000000002
00000000000000200000000000000002
00000000000000200000000000000002
00000000000000220000000000000002
00000000000000000000000000000002
00000000000000000000000000000002
09010101010101010000000000000002
03000000000000000000000000000002
03000000000000000000000000000002