09010101010101000001010101010108
03000000000000000000000000000002
03000000000000000000000000000002
03000000000000000000000000000002
03000000000000000000000000000002
03000000000000000000000000000002
03000000000000000000000000000002
03000000000018000000000000000002
03000000000000000000000000000002
03000000000000000000000000000002
03000000000000000000000000000002
10191919191919191919191919191911