1111111111111111
0000000000000000
0000000000000000
0000010000000000
0000000000000000
0000000000000000
0000000000200000
0000000000000000
6666666650000000
0000000070000000
0000000070000001
1000000070000001