0000000000000000
0010000000000200
0300000000000030
0000000000040000
0000000000000000
0000000000000000
0500005000000050
0000000000000000
0000000000040000
0600000000000060
0010000000000200
0000000000000000