11111111111111111111
00000000000000000000
00000000000000000000
00001111111111110000
00000000000000000000
00000000000000000000
00000000000000000000
00000000000000000000
00022222222222220000
00000000000000000000
00000000000000000000
00000000000000000000